1111111111111111111111111111111111
1000000000000000000000000000000001
1000000000000000000000000000000001
100000000000000000P000000000000001
1000000000000000000000000000000001
1000000000000000000000000000000001
1000000000000000000000000000000001
1000000000000000000000000000000001
1000000000000000000000000000000001
1000000000000000000000000000000001
1111011111111111111111111111111111
1CCCC000C0C00CC00CC000000000000001
1000000000000000000000000000000001
10C000001C00000000C000000000000001
1111111111111111111111111110111111
1000000C000000000000000000000000E1
1111111111111111111111111111111111